1111111111111111111111111111111111
1E0000000100C00C00000C0000000000C1
10100101001000001010010000C0010101
1010010010101010001001000100010101
1P0000000C00C00000000C0000000000C1
10100101001000001010010000C0010101
1010010010101010001001000100010101
10100101001000001010010000C0010101
1010010010101010001001000100010101
1111111111111111111111111111111111