1111111111111111111111111111111111
1C0000000100X00C00000C0000000000X1
10100101001000001010010000C0010101
101001000001010010000C0010101X0001
1010010010101010001001000100010101
1010010010101010E01001000100010101
1P0000000C00C000001010010000101001
1010010010101010001001000100010101
1000X0000000000C10000C0010101000C1
1111111111111111111111111111111111